NO ./textures/walls/n_wall.xpm
SO ./textures/walls/s_wall.xpm
WE ./textures/walls/w_wall.xpm
EA ./textures/walls/e_wall.xpm

F 128,128,128
C 135,206,235

        11111111111111111111111111111
11111111100000000000000000C000000000111111111
1D00100000000000000000000011111111111
100010000000000001000000001
10001000000D000001100000001
11C110000011100000000000001
10000000000D00000EO00000001
10000000000D000000000000001
100000000000000000000000001
111111111111111111111111111