


NO          ./textures/walls/n_wall.xpm


F     128,128,128


WE         ./textures/walls/w_wall.xpm



EA ./textures/walls/e_wall.xpm


SO ./textures/walls/s_wall.xpm

C 135,206,235

           1
          101
         10001
        100W001
11111111111111111111111