111111111111111111111111111
100010000000000000000000001
100010000000000000000000001
101110000000000001100000001
100000000000000001100000001
100000000011100000000000001
10000000000000000P000000001
100000000000000000000000001
100000000000000000000000001
111111111111111111111111111