NO ./textures/n_wall.xpm
SO ./textures/s_wall.xpm
WE ./textures/w_wall.xpm
EA ./textures/e_wall.xpm

F 128,128,128
C 135,206,235

        11111111111111111111111111111
111111111000000000000000000000000000111111111
1000100000000000000000000011111111111
101110000000000001100000001
100000000000000001100000001
100000000011100000000000001
100000O000000D000E000000001
100000C00000000000000000001
100000000000000000000000001
111111111111111111111111111