SO ./textures/walls/s_wall.xpm
NO ./textures/walls/n_wall.xpm
EA ./textures/walls/e_wall.xpm
WE ./textures/walls/w_wall.xpm

F 128,128,128
C 135,206,235

1111111111
10D0100001
1000100001
11C1100001
1000000001
10N0000001
1111111111