


NO          ./textures/walls/n_wall.xpm


F     128,128,128


WE         ./textures/walls/w_wall.xpm



EA ./textures/walls/e_wall.xpm



SO ./textures/walls/s_wall.xpm

C 135,206,235

11111
11001
110W1
11111