111111111111111111111111111
1P0000000000000000000000001
100000000000000000000000001
100000000000000001100000001
100000000000000001100000001
10000000001110 	0000000000001
100000000000000000000000001
100000000000000000000000001
100000000000000000000000001
111111111111111111111111111