NO ./textures/n_wall.xpm
SO ./textures/s_wall.xpm
WE ./textures/w_wall.xpm
EA ./textures/e_wall.xpm

F 128,128,128
C 135,206,235

        11111111111111111111111111111
11111111100000000000000000C000000000111111111
1000100000000000000000000011111111111
100010000000000001000000001
100010000000000001100000001
11C110000011100000000000001
1000000000000D000WO00000001
100000000000000000000000001
100000000000000000000000001
111111111111111111111111111