NO ./textures/n_wall.xpm
SO ./textures/s_wall.xpm
WE ./textures/w_wall.xpm
EA ./textures/e_wall.xpm

F 128,128,128
C 135,206,235

		1111111111111111111111111111
111111111000000000000000000000000000111111111
100010000000000000000000001111111111
101110000000000001100000001
100000000000000001100000001
100000000011100000000000001
1000000000000D000P000000001
100000000000000000000000001
100000000000000000000000001
11111111111111111111111111