111111111111111111111111111
100000000000000000000000001
100000000000000000000000001
10000000000000000110000001
10000000000000P001100000001
100000000011100000000000001
100000000000000000000000001
100000000000000000000000001
100000000000000000000000001
111111111111111111111111111